{
  "maps": {
    "0": [
    "########",
    "#      #",
    "#P C   #",
    "# 1  9 X",
    "#      #",
    "# C   9#",
    "# M    #",
    "########"
    ],
	"1": [
    "########",
    "X4 M   #",
    "#4222  #",
    "#      #",
    "#      #",
    "#      #",
    "#     PS",
    "########"
    ]
  }
}