{
  "maps": {
	 "0": [
    "########",
    "XRM    #",
    "#RBBB  #",
    "#      #",
    "#      #",
    "#      #",
    "#      E",
    "########"
    ]
  }
}