{
  "maps": {
    "0": [
    "########",
    "#  T   #",
    "#P C   #",
    "# 1  9 X",
    "#      #",
    "# C   9#",
    "# M    #",
    "########"
    ],
    "1": [
    "######X#",
    "#4     #",
    "#   M  #",
    "#6    2#",
    "#T     #",
    "#  PT  #",
    "#      #",
    "########"
    ],
    "2": [
    "########",
    "X4     #",
    "# M    #",
    "# C2E  #",
    "# 2T52 #",
    "# P14  #",
    "# 888  #",
    "########"
    ],
    "3": [
    "########",
    "#2T    #",
    "#26 E 3#",
    "#  P   #",
    "# 4MC  #",
    "X8C 4 3#",
    "#   1  #",
    "########"
    ],
    "4": [
    "########",
    "X4 M   #",
    "#4222  #",
    "#      #",
    "#      #",
    "#      #",
    "#     P#",
    "########"
    ],
    "5": [
    "########",
    "# M4   #",
    "#  4   #",
    "#  4   #",
    "#  4 T #",
    "#      #",
    "#   P  #",
    "##X#####"
    ]
  }
}