{
  "maps": {
	 "0": [
    "########",
    "XR M   #",
    "#RBBB  #",
    "#      #",
    "#      #",
    "#      #",
    "#     PE",
    "########"
    ]
  }
}