{
  "maps": {
    "0": [
    "########",
    "#  T   #",
    "#P C   #",
    "# 1  9 X",
    "#      #",
    "# C   9#",
    "# M    #",
    "########"
    ],
    "1": [
    "######X#",
    "#4     #",
    "#   M  #",
    "#6    2#",
    "#T     #",
    "#  PT  #",
    "#      #",
    "########"
    ],
    "2": [
    "########",
    "X4     #",
    "# M    #",
    "# C2E  #",
    "#T2T52 #",
    "# P14  #",
    "# 888  #",
    "########"
    ],
    "3": [
    "##X#####",
    "#T  4  #",
    "# 4 T P#",
    "#   8  #",
    "# 22  2#",
    "#4   2 #",
    "#4M    #",
    "########"
    ],
    "4": [
    "#####X##",
    "#M 2 2 #",
    "#4     #",
    "#T P B #",
    "#C 82  #",
    "#44    #",
    "#T C   #",
    "########"
    ],
    "5": [
    "########",
    "X4 T  1#",
    "#2 P 2M#",
    "# 26T 2#",
    "#      #",
    "#  4 3 #",
    "#T     #",
    "########"
    ],
    "6": [
    "####X###",
    "#  M4 T#",
    "#28C 28#",
    "#T 4T 2#",
    "# 16CPT#",
    "# 624 1#",
    "#      #",
    "########"
    ],
    "7": [
    "########",
    "#2T    #",
    "#26 E 3#",
    "#  P   #",
    "# 4MC  #",
    "X8C 4 3#",
    "#   1  #",
    "########"
    ],
    "8": [
    "########",
    "#  13P #",
    "#2  19 #",
    "#T3  12#",
    "# 22 2T#",
    "#   6T3#",
    "#T1M   X",
    "########"
    ],
    "9": [
    "########",
    "#  12 T#",
    "#C     #",
    "#  T96 #",
    "#2  32P#",
    "# 2289 #",
    "#T  M M#",
    "#####X##"
    ]
  }
}